"Anno","Mese","Codice Istat","Provincia","Matrimoni religiosi","Matrimoni civili","Totale"
"2004","Gennaio","037","Bologna","32","64","96"
"2004","Febbraio","037","Bologna","41","96","137"
"2004","Marzo","037","Bologna","28","83","111"
"2004","Aprile","037","Bologna","101","123","224"
"2004","Maggio","037","Bologna","253","218","471"
"2004","Giugno","037","Bologna","330","193","523"
"2004","Luglio","037","Bologna","178","175","353"
"2004","Agosto","037","Bologna","51","83","134"
"2004","Settembre","037","Bologna","330","207","537"
"2004","Ottobre","037","Bologna","130","129","259"
"2004","Novembre","037","Bologna","20","77","97"
"2004","Dicembre","037","Bologna","52","111","163"
"2004","Tutti i mesi","037","Bologna","1546","1559","3105"
"2005","Gennaio","037","Bologna","26","93","119"
"2005","Febbraio","037","Bologna","23","81","104"
"2005","Marzo","037","Bologna","16","92","108"
"2005","Aprile","037","Bologna","149","157","306"
"2005","Maggio","037","Bologna","151","140","291"
"2005","Giugno","037","Bologna","333","205","538"
"2005","Luglio","037","Bologna","205","190","395"
"2005","Agosto","037","Bologna","48","99","147"
"2005","Settembre","037","Bologna","306","191","497"
"2005","Ottobre","037","Bologna","140","155","295"
"2005","Novembre","037","Bologna","15","70","85"
"2005","Dicembre","037","Bologna","56","138","194"
"2005","Tutti i mesi","037","Bologna","1468","1611","3079"
"2006","Gennaio","037","Bologna","17","89","106"
"2006","Febbraio","037","Bologna","31","88","119"
"2006","Marzo","037","Bologna","13","102","115"
"2006","Aprile","037","Bologna","103","137","240"
"2006","Maggio","037","Bologna","153","181","334"
"2006","Giugno","037","Bologna","319","237","556"
"2006","Luglio","037","Bologna","240","216","456"
"2006","Agosto","037","Bologna","57","92","149"
"2006","Settembre","037","Bologna","365","226","591"
"2006","Ottobre","037","Bologna","85","125","210"
"2006","Novembre","037","Bologna","10","69","79"
"2006","Dicembre","037","Bologna","52","141","193"
"2006","Tutti i mesi","037","Bologna","1445","1703","3148"
"2007","Gennaio","037","Bologna","15","77","92"
"2007","Febbraio","037","Bologna","24","94","118"
"2007","Marzo","037","Bologna","22","129","151"
"2007","Aprile","037","Bologna","92","139","231"
"2007","Maggio","037","Bologna","154","187","341"
"2007","Giugno","037","Bologna","360","255","615"
"2007","Luglio","037","Bologna","226","231","457"
"2007","Agosto","037","Bologna","30","79","109"
"2007","Settembre","037","Bologna","375","244","619"
"2007","Ottobre","037","Bologna","95","153","248"
"2007","Novembre","037","Bologna","17","92","109"
"2007","Dicembre","037","Bologna","64","180","244"
"2007","Tutti i mesi","037","Bologna","1474","1860","3334"
"2008","Gennaio","037","Bologna","20","86","106"
"2008","Febbraio","037","Bologna","23","95","118"
"2008","Marzo","037","Bologna","27","139","166"
"2008","Aprile","037","Bologna","108","149","257"
"2008","Maggio","037","Bologna","176","233","409"
"2008","Giugno","037","Bologna","335","259","594"
"2008","Luglio","037","Bologna","173","183","356"
"2008","Agosto","037","Bologna","77","125","202"
"2008","Settembre","037","Bologna","289","207","496"
"2008","Ottobre","037","Bologna","110","157","267"
"2008","Novembre","037","Bologna","15","89","104"
"2008","Dicembre","037","Bologna","53","135","188"
"2008","Tutti i mesi","037","Bologna","1406","1857","3263"
"2009","Gennaio","037","Bologna","21","78","99"
"2009","Febbraio","037","Bologna","28","102","130"
"2009","Marzo","037","Bologna","16","121","137"
"2009","Aprile","037","Bologna","73","142","215"
"2009","Maggio","037","Bologna","177","240","417"
"2009","Giugno","037","Bologna","276","258","534"
"2009","Luglio","037","Bologna","189","211","400"
"2009","Agosto","037","Bologna","62","117","179"
"2009","Settembre","037","Bologna","284","211","495"
"2009","Ottobre","037","Bologna","91","149","240"
"2009","Novembre","037","Bologna","18","73","91"
"2009","Dicembre","037","Bologna","63","128","191"
"2009","Tutti i mesi","037","Bologna","1298","1830","3128"
"2010","Gennaio","037","Bologna","20","76","96"
"2010","Febbraio","037","Bologna","17","74","91"
"2010","Marzo","037","Bologna","9","106","115"
"2010","Aprile","037","Bologna","63","126","189"
"2010","Maggio","037","Bologna","169","219","388"
"2010","Giugno","037","Bologna","254","248","502"
"2010","Luglio","037","Bologna","231","216","447"
"2010","Agosto","037","Bologna","48","111","159"
"2010","Settembre","037","Bologna","246","241","487"
"2010","Ottobre","037","Bologna","112","164","276"
"2010","Novembre","037","Bologna","11","57","68"
"2010","Dicembre","037","Bologna","37","106","143"
"2010","Tutti i mesi","037","Bologna","1217","1744","2961"
"2011","Gennaio","037","Bologna","11","54","65"
"2011","Febbraio","037","Bologna","18","63","81"
"2011","Marzo","037","Bologna","17","93","110"
"2011","Aprile","037","Bologna","40","121","161"
"2011","Maggio","037","Bologna","148","200","348"
"2011","Giugno","037","Bologna","269","246","515"
"2011","Luglio","037","Bologna","201","253","454"
"2011","Agosto","037","Bologna","34","65","99"
"2011","Settembre","037","Bologna","246","213","459"
"2011","Ottobre","037","Bologna","64","144","208"
"2011","Novembre","037","Bologna","10","76","86"
"2011","Dicembre","037","Bologna","34","117","151"
"2011","Tutti i mesi","037","Bologna","1092","1645","2737"
"2012","Gennaio","037","Bologna","13","58","71"
"2012","Febbraio","037","Bologna","17","54","71"
"2012","Marzo","037","Bologna","16","104","120"
"2012","Aprile","037","Bologna","63","119","182"
"2012","Maggio","037","Bologna","111","190","301"
"2012","Giugno","037","Bologna","258","275","533"
"2012","Luglio","037","Bologna","165","204","369"
"2012","Agosto","037","Bologna","34","91","125"
"2012","Settembre","037","Bologna","279","290","569"
"2012","Ottobre","037","Bologna","58","157","215"
"2012","Novembre","037","Bologna","10","68","78"
"2012","Dicembre","037","Bologna","42","160","202"
"2012","Tutti i mesi","037","Bologna","1066","1770","2836"
"2013","Gennaio","037","Bologna","9","42","51"
"2013","Febbraio","037","Bologna","6","71","77"
"2013","Marzo","037","Bologna","7","103","110"
"2013","Aprile","037","Bologna","55","123","178"
"2013","Maggio","037","Bologna","91","172","263"
"2013","Giugno","037","Bologna","245","313","558"
"2013","Luglio","037","Bologna","134","179","313"
"2013","Agosto","037","Bologna","45","115","160"
"2013","Settembre","037","Bologna","222","255","477"
"2013","Ottobre","037","Bologna","60","145","205"
"2013","Novembre","037","Bologna","10","77","87"
"2013","Dicembre","037","Bologna","46","121","167"
"2013","Tutti i mesi","037","Bologna","930","1716","2646"
"2014","Gennaio","037","Bologna","5","50","55"
"2014","Febbraio","037","Bologna","5","67","72"
"2014","Marzo","037","Bologna","23","86","109"
"2014","Aprile","037","Bologna","31","122","153"
"2014","Maggio","037","Bologna","101","197","298"
"2014","Giugno","037","Bologna","240","257","497"
"2014","Luglio","037","Bologna","154","232","386"
"2014","Agosto","037","Bologna","62","125","187"
"2014","Settembre","037","Bologna","236","253","489"
"2014","Ottobre","037","Bologna","47","148","195"
"2014","Novembre","037","Bologna","8","88","96"
"2014","Dicembre","037","Bologna","19","122","141"
"2014","Tutti i mesi","037","Bologna","931","1747","2678"
"2015","Gennaio","037","Bologna","6","75","81"
"2015","Febbraio","037","Bologna","10","87","97"
"2015","Marzo","037","Bologna","5","105","110"
"2015","Aprile","037","Bologna","38","109","147"
"2015","Maggio","037","Bologna","121","225","346"
"2015","Giugno","037","Bologna","204","297","501"
"2015","Luglio","037","Bologna","156","244","400"
"2015","Agosto","037","Bologna","71","130","201"
"2015","Settembre","037","Bologna","191","260","451"
"2015","Ottobre","037","Bologna","63","176","239"
"2015","Novembre","037","Bologna","7","81","88"
"2015","Dicembre","037","Bologna","23","122","145"
"2015","Tutti i mesi","037","Bologna","895","1911","2806"
"2016","Gennaio","037","Bologna","6","71","77"
"2016","Febbraio","037","Bologna","7","86","93"
"2016","Marzo","037","Bologna","1","93","94"
"2016","Aprile","037","Bologna","54","164","218"
"2016","Maggio","037","Bologna","83","219","302"
"2016","Giugno","037","Bologna","216","307","523"
"2016","Luglio","037","Bologna","180","270","450"
"2016","Agosto","037","Bologna","46","104","150"
"2016","Settembre","037","Bologna","202","284","486"
"2016","Ottobre","037","Bologna","61","187","248"
"2016","Novembre","037","Bologna","8","91","99"
"2016","Dicembre","037","Bologna","32","133","165"
"2016","Tutti i mesi","037","Bologna","896","2009","2905"
"2017","Gennaio","037","Bologna","7","65","72"
"2017","Febbraio","037","Bologna","11","62","73"
"2017","Marzo","037","Bologna","5","75","80"
"2017","Aprile","037","Bologna","42","126","168"
"2017","Maggio","037","Bologna","80","179","259"
"2017","Giugno","037","Bologna","182","292","474"
"2017","Luglio","037","Bologna","174","271","445"
"2017","Agosto","037","Bologna","39","109","148"
"2017","Settembre","037","Bologna","212","324","536"
"2017","Ottobre","037","Bologna","42","156","198"
"2017","Novembre","037","Bologna","6","84","90"
"2017","Dicembre","037","Bologna","29","138","167"
"2017","Tutti i mesi","037","Bologna","829","1881","2710"
"2018","Gennaio","037","Bologna","2","71","73"
"2018","Febbraio","037","Bologna","5","88","93"
"2018","Marzo","037","Bologna","3","103","106"
"2018","Aprile","037","Bologna","47","141","188"
"2018","Maggio","037","Bologna","72","227","299"
"2018","Giugno","037","Bologna","210","353","563"
"2018","Luglio","037","Bologna","108","207","315"
"2018","Agosto","037","Bologna","37","117","154"
"2018","Settembre","037","Bologna","200","330","530"
"2018","Ottobre","037","Bologna","34","173","207"
"2018","Novembre","037","Bologna","5","90","95"
"2018","Dicembre","037","Bologna","27","158","185"
"2018","Tutti i mesi","037","Bologna","750","2058","2808"
"2019","Gennaio","037","Bologna","4","78","82"
"2019","Febbraio","037","Bologna","4","82","86"
"2019","Marzo","037","Bologna","5","93","98"
"2019","Aprile","037","Bologna","17","134","151"
"2019","Maggio","037","Bologna","83","187","270"
"2019","Giugno","037","Bologna","183","347","530"
"2019","Luglio","037","Bologna","121","207","328"
"2019","Agosto","037","Bologna","44","131","175"
"2019","Settembre","037","Bologna","179","312","491"
"2019","Ottobre","037","Bologna","48","200","248"
"2019","Novembre","037","Bologna","7","96","103"
"2019","Dicembre","037","Bologna","14","122","136"
"2019","Tutti i mesi","037","Bologna","709","1989","2698"
"2020","Gennaio","037","Bologna","6","65","71"
"2020","Febbraio","037","Bologna","2","115","117"
"2020","Marzo","037","Bologna","1","43","44"
"2020","Aprile","037","Bologna","2","16","18"
"2020","Maggio","037","Bologna","5","69","74"
"2020","Giugno","037","Bologna","21","171","192"
"2020","Luglio","037","Bologna","18","187","205"
"2020","Agosto","037","Bologna","46","126","172"
"2020","Settembre","037","Bologna","111","247","358"
"2020","Ottobre","037","Bologna","57","203","260"
"2020","Novembre","037","Bologna","1","95","96"
"2020","Dicembre","037","Bologna","8","140","148"
"2020","Tutti i mesi","037","Bologna","278","1477","1755"
"2021","Gennaio","037","Bologna","1","68","69"
"2021","Febbraio","037","Bologna","4","63","67"
"2021","Marzo","037","Bologna","1","85","86"
"2021","Aprile","037","Bologna","6","70","76"
"2021","Maggio","037","Bologna","40","162","202"
"2021","Giugno","037","Bologna","103","257","360"
"2021","Luglio","037","Bologna","172","259","431"
"2021","Agosto","037","Bologna","66","124","190"
"2021","Settembre","037","Bologna","204","329","533"
"2021","Ottobre","037","Bologna","51","213","264"
"2021","Novembre","037","Bologna","2","84","86"
"2021","Dicembre","037","Bologna","4","162","166"
"2021","Tutti i mesi","037","Bologna","654","1876","2530"
"2022","Gennaio","037","Bologna","2","63","65"
"2022","Febbraio","037","Bologna","10","79","89"
"2022","Marzo","037","Bologna","5","112","117"
"2022","Aprile","037","Bologna","19","148","167"
"2022","Maggio","037","Bologna","70","267","337"
"2022","Giugno","037","Bologna","172","348","520"
"2022","Luglio","037","Bologna","122","322","444"
"2022","Agosto","037","Bologna","44","143","187"
"2022","Settembre","037","Bologna","191","356","547"
"2022","Ottobre","037","Bologna","48","202","250"
"2022","Novembre","037","Bologna","4","93","97"
"2022","Dicembre","037","Bologna","13","156","169"
"2022","Tutti i mesi","037","Bologna","700","2289","2989"
"2023","Gennaio","037","Bologna","4","80","84"
"2023","Febbraio","037","Bologna","6","69","75"
"2023","Marzo","037","Bologna","5","111","116"
"2023","Aprile","037","Bologna","21","152","173"
"2023","Maggio","037","Bologna","72","274","346"
"2023","Giugno","037","Bologna","160","388","548"
"2023","Luglio","037","Bologna","94","272","366"
"2023","Agosto","037","Bologna","26","136","162"
"2023","Settembre","037","Bologna","170","392","562"
"2023","Ottobre","037","Bologna","41","225","266"
"2023","Novembre","037","Bologna","8","109","117"
"2023","Dicembre","037","Bologna","17","143","160"
"2023","Tutti i mesi","037","Bologna","624","2351","2975"